@@@@@@@@@@
@@####B##@
@@D@*#*#*@
@*#*#@#B@
@@D@*#***@
@@####B#@
@@@@@@@@@@