@@@@@@@@@@@@@@@@@@@
 @#B#####**#*####@
  @*#B*###**B###@
   @####**D*###@
    @###B#####@
    @##*##B##@
   @##D#####@
  @######@#@
 @@@@@@@@@@  