  @@  @@  
 @##@@B#@@@
@B#B*###B##@@
 @##B##@#####@
  @##@########@@
   @############@
  @##D#*#*#####@
  @#@@##B#@#D#@
   @  @@@@ @@@