@@@@@@@@@@@
@####B@#D#@
@#@@@#####@
@#@***@#@*@
@B#B#######@
@*@*@*@#@*#B@
@#D#@B####B#@
@*####@*#*##@
@@@@@@ @@@@@@