@@@@@@@@@@@@
@#####*####@@@
 @#**####*@##B@
@#####**D**####@@@
 @B*###*#*@D###*#B@
@###B###B##@@##B##@
@#################@
 @##B####@@@@###@@
  @@@@@@@@  @@@@