 @@@@@
@#####@
@#B##B@
@DD###@
 @@@@@