  @@@@  @@@@@@
 @#BB#@@##B###@
@#@##########@
@##@B@B#####@
@###@##@@####@@
 @####@  @#B##B@
@##D#@    @#D#*#@
@@@@@      @@@@@