@@@@@@
@#B*D#@ @@@@
@##B##@@@D*@
@##B#######@
@#B###@@@@@
@@@@@@