@@@@@@@@ @@@@@
@B#####@ @D##@
@#B**#B@@@*##@
@*#D#@####B##@
@#B###@@@@###@
@####B@  @###@
@@@@@@   @@@@