@@@@@@@@
@B##D#D@
@@#@@#@
@B###B@
@@@@@@