    @        @
   @D@      @D@
  @###@    @###@
 @B##B#@@@@#####@
  @###B###B###B@
   @######B*##@
  @###@*@@#@###@
   @@@ @  @ @@@  