@@@@@@@@@@@
@##@#@B@#@D@
@#####B####@
@D@#@#@#@##@
 @@@@@@@@@@