 @@@@@@@
@######*@@@@
@#@D*###D##B@
@##@B###B@@@
@@BB@###@
 @######@
  @@@@@@