@@@@@@@
@B#@#@D@@
@####B#@@
@B@DB@@
@@@@@